"filename", "language", "C++", "comment", "blank", "total"
"c:\repository\algnet\project_8\include\Event.hpp", "C++", 14, 0, 11, 25
"c:\repository\algnet\project_8\include\EventScheduler.hpp", "C++", 14, 0, 10, 24
"c:\repository\algnet\project_8\include\Flow.hpp", "C++", 16, 0, 4, 20
"c:\repository\algnet\project_8\include\Link.hpp", "C++", 17, 1, 7, 25
"c:\repository\algnet\project_8\include\NetworkDevice.hpp", "C++", 25, 0, 7, 32
"c:\repository\algnet\project_8\include\NetworkSimulator.hpp", "C++", 21, 0, 6, 27
"c:\repository\algnet\project_8\include\Packet.hpp", "C++", 21, 1, 3, 25
"c:\repository\algnet\project_8\include\Receiver.hpp", "C++", 9, 0, 3, 12
"c:\repository\algnet\project_8\include\Sender.hpp", "C++", 9, 0, 3, 12
"c:\repository\algnet\project_8\include\Switch.hpp", "C++", 20, 5, 8, 33
"c:\repository\algnet\project_8\src\Event.cpp", "C++", 17, 0, 4, 21
"c:\repository\algnet\project_8\src\EventScheduler.cpp", "C++", 36, 0, 5, 41
"c:\repository\algnet\project_8\src\Flow.cpp", "C++", 16, 0, 4, 20
"c:\repository\algnet\project_8\src\Link.cpp", "C++", 16, 0, 5, 21
"c:\repository\algnet\project_8\src\NetworkDevice.cpp", "C++", 29, 0, 4, 33
"c:\repository\algnet\project_8\src\NetworkSimulator.cpp", "C++", 21, 0, 5, 26
"c:\repository\algnet\project_8\src\Packet.cpp", "C++", 32, 0, 9, 41
"c:\repository\algnet\project_8\src\Receiver.cpp", "C++", 33, 5, 5, 43
"c:\repository\algnet\project_8\src\Sender.cpp", "C++", 32, 6, 7, 45
"c:\repository\algnet\project_8\src\Switch.cpp", "C++", 32, 6, 5, 43
"c:\repository\algnet\project_8\src\main.cpp", "C++", 5, 0, 2, 7
"Total", "-", 435, 24, 117, 576